repine	抱怨
opine	认为
supine	懒散的
saccharine	甜味的
elephantine	巨大的
quarantine	隔离
byzantine	错综复杂的
serpentine	弯曲的
libertine	放荡不羁的
predestine	预先注定
clandestine	隐藏的，秘密的
philistine	市侩
pristine	质朴的
sanguine	乐观的
condone	宽恕
hone	磨快
drone	低沉地说
chaperone	护送
atone	赎罪
jejune	乏味的
immune	免疫
prune	修剪
importune	恳求
opportune	合适的
attune	使协调
anodyne	无害的
agape	急切盼望地
shipshape	井然有序地
jape	嘲弄
gripe	抱怨
trope	比喻，陈词滥调
dupe	欺骗
archetype	榜样
stereotype	老套的理念
prototype	原型
threadbare	陈腐的
snare	困境
macabre	恐怖的
mediocre	平庸的，中偏下的
adhere	服从，遵守
sere	干枯的
austere	朴素的
revere	对神的崇敬
persevere	不屈不挠
doctrinaire	教条主义的
dire	可怕的
backfire	事与愿违
mire	困境
repertoire	原料详单
conspire	密谋
expire	死亡
acquire	获得
bore	厌烦的事物
underscore	强调
adore	喜爱
deplore	哀悼
pore	仔细研究
sinecure	美差
epicure	美食家
procure	获得
obscure	模糊的
transfigure	变装
abjure	放弃，抵制，避免
conjure	恳求，想起
allure	吸引
immure	监禁
inure	养成坏习惯
censure	谴责
reassure	使安心
caricature	讽刺画
immature	不成熟的
stature	高度，水平
fracture	打碎
conjecture	揣测
stricture	批评
divestiture	剥夺
rupture	打碎
overture	前言
nurture	养育
posture	故作姿态
suture	缝合
abase	降低
debase	贬低
showcase	展示优点
chase	驱赶
blase	腻烦的
paraphrase	转述
malaise	不舒服
imprecise	不精确的
exorcise	除去
paradise	快乐
enfranchise	给予权力
compromise	妥协
surmise	揣测
despise	极其不喜欢
apprise	告知
improvise	即兴创作
repulse	排斥，使厌恶
incense	激怒
