vagary	不可预测的行为
chary	谨慎的
intermediary	中间人
subsidiary	次要的
incendiary	煽动的
pecuniary	金钱上的
ancillary	次要的
exemplary	榜样的
mercenary	唯利是图的
luminary	杰出人物
visionary	空想的
reactionary	保守的
discretionary	自主决定的
eleemosynary	慈善的
hoary	老的
arbitrary	专横的
adversary	对手
proprietary	私营的
sanitary	清洁的
sedentary	固定的
complementary	互补的
rudimentary	基础的
votary	信徒
salutary	有益的
sanctuary	避难所
wary	小心的
decry	否定
tawdry	俗丽的
leery	怀疑的
drudgery	苦工
skullduggery	欺诈
mockery	嘲笑
chicanery	欺骗
slippery	光滑的，意味不明的
